#########      ############         ##########                                 
#    R  #      #   R      ########### R    R #                                 
#       ########                        R R  #                               
#   @             Z   R   ###########  R     #                                 
#       ########          #         ##########                                 
#     R #      #   R      #                                               
#########      ############                                                
    